"room","phone"
"0","1515"
"1","1516"
"2","1617"
"3","1601"
"4","1041"
"5","9212"
"6","1424"
"7","1294"